3ALAA3333ELA3yLLB3AByiL
ByE33EL3E3B3BA33B333ELB
EAL33B333BEyLiLAy3BB3IB
3AAAAB33L3ABA3LA3LEEELA
ALiL33BAAELAAy33L3BAALL
L333BIA3E333y3AB3EAAL3L
AyLB33i33BE3AB333E3EyiL
3IA3L3LEL33IL33ABLL3BE3
A3A3AyA3Ly33LyAE3y33y3L
By33LEEALLE3ByLLB333LI3
yEI33yA3ELLABLE3L3yE33I
