FF8888Fa8aF8EOAAa8rOaEaAAi
aaO888O8EaOEaEE8raOaE8888a
8aAaFaE88raFR8EEaaaAEFFF8a
8arIaO8ErA8a8F88FrOaF8OOaO
a88EiO8AaEA88E88O8a8aAF8Er
aia8iIa88a8Raaa88a8a8A8O8F
aar8OaO88OEa8O8aE8aaFaA8IF
8aarF8RaAaOaREAaFaA888aAFI
8aa88aOR88A88aOaFaEER88aAr
a8a8aaaO88OaaiF8OaRAiaaEaA
aO8R88Aa8EFOAI8EAO8OaOaOar
