FF8888Fa8aF8EAAAa8rOaEaAAi
aaO888O8EaOaaEE8raOaE8888a
8aAaFaE88raF88EEaaaAEFFF8a
8arIaO8ErA8a8A88FrOai8OOaO
a88EROIAaEA88E88O8a8aAF8Er
aaa8iIa88a8Raaa88a8a8A8O8F
aar8OaO88OEa8O8aE8aaFaA8IF
Oa8rF8FaAaOrREA8FaA888aAFI
8aa88IOR88A88aOaFaEER88aFr
a8a8aaa888OaaiF8OaRAiaaEaA
aO8RI8Aa8EFOAI8EAO8OaOaOar
