FF8888Fa8aF8EAAAa8rOaEaAAi
aaO888O8EaOaaEE8raOaE8888a
8aAaFaE88raF88EEaaaAEFFF8a
8arIaO8ErA8a8a88FrOaF8OOaO
a88EOO8AaEA88E88O8a8aAF8Er
aaa8iIa88a8Raaa88a8a8A8O8F
aar8OaO88OEa8O8aE8aaFaA8IF
8a8rF8FaAaOaREAaFaA888aAFI
8aa88aOR88A88aOaFaEER88aAr
a8a8aaa888OaaiF8OaRAiaaEaA
