FF6666Fi6iF6EAAAi6rOiEiAAI
iiO666O6EiOiiEE6riOiE6666i
6iAiFiE66riF66EEiiiAEFFF6i
6irSiO6ErA6i6i66FrOiF6OOiO
i66EOO6AiEA66E66O6i6iAF6Er
iii6ISi66i6Riii66i6i6A6O6F
iir6OiO66OEi6O6iE6iiFiA6SF
6i6rF6FiAiOiREAiFiA666iAFS
6ii66iOR66A66iOiFiEER66iAr
i6i6iii666OiiIF6OiRAIiiEiA
iO6R66Ai6EFOAS6EAO6OiOiOir
