FFPPPPF2P2FPEAAA2PrO2E2AAi
22OPPPOPE2O22EEPr2O2EPPPP2
P2A2F2EPPr2FPPEE222AEFFFP2
P2rI2OPErAP2P2PPFrO2FPOO2O
2PPEOOPA2EAPPEPPOP2P2AFPEr
222PiI2PP2PR222PP2P2PAPOPF
22rPO2OPPOE2POP2EP22F2APIF
P2PrFPF2A2O2REA2F2APPP2AFI
P22PP2ORPPAPP2O2F2EERPP2Ar
2P2P222PPPO22iFPO2RAi22E2A
2OPRPPA2PEFOAIPEAOPO2O2O2r
