7II9mm7E7m7I79MmA7m97A7m7ME
7A7m77Mm9Mm7mM7A77AEmE79777
7M9mM979A977977777997EE797I
9MM7779A77AA77m977MA9Im9E9m
mM7AEr79E7mMAm9997799M9E7mm
77M7Im97m97M7979mM7EEA99E9m
7M997m9Em9m99AEA777E9797mM9
9E9m79I97M77977779mEEIm7mEI
779A97999IA97A779M997MMm9Em
97m7777MI7A9777A997IMEA999r
A9779779A9777979777IAAAm7Mm
