vvvvvvBAARvvRvEABBRvvRRv
RRvRLRRBvBBvvBevvRvvRRRR
vvRvRvvRRBRARBRBRvvRReRR
vvvBIRRvvRvvBLRARvBRRvRv
vvvvAAARRAvRvRvBRAvIRBRR
vRRRRLBRvLvAvBRvvRRRBRRR
RRvRRAAvRRRRvvBRvBvBRvvB
vRRRvvRAALLvvLRAvLvveRvA
vRvvABARvvRvvARvvRRvvAvv
RvvAvRARAvRvRvRRRARvRRRA
AARBvRRRRRRRBvRRARvBRvvA
