vvvvvvBAAvvvRvRABBRvvRRv
RRvRLRRBvRBvvBRvvRvvRRRR
vvRvRvviRBRARBRBRvvRRRRR
vvvBvRRvvRvvivRARvBRRvBv
vvvvAAARRAvRvRvBRLvRRBAR
vRRRRLBRvLvAvBRvvRRRBRRR
RRvRRAAvRRRRvvBRvIvBRvvB
vRRRvviAALLvvLRAvLvvRRvA
vRvvABARvvRvvARvvRRvvAvv
RvvAvRARAvRARvRRRARvRRRA
AARBvRRRRReRBvRRARvBRvvA
