vvvvvvBAAvvvRvRABBRvvvRv
RRvRLRRBvRBvvBRvvRvvRRRR
vvRvRvvRRBRARBRBRvvRRRRR
vvvBvRRvvRvvBvRARvBRRvRv
vvvvAAARRAvRvRvBRAvRRBRR
vRRRRLBRILvAvBRvvRRRBRRR
RRvRRAevRRRRvvBRvBvBRvvB
vRRRvvRIILLvvLRAILvvRRvA
vRvvABARvvRvvARvvRRvvAvv
RvvAvReRAvRvRvRRRARvRRRe
BARBvRRRRRRRBvRRARvBRvvA
