vvvvvvBAAvvvRvRABeRvvRRv
RRvRLRRBvRBvvBRvvBvvRRAR
vvRvRvvRRBRARBRBRvvRRRRR
vvvBvRRvvRvvBvRARvBRRvRv
vvvvAAARRAvRvRvBRAvRRBRR
vRRRRLBRvLvAvBRvvRBRBARR
RRvRRAARRRRRvvBRvRvBRvvB
vRRRvvRAALLvvLiAvLvvRRvA
vRvvABARvvRvvARvvRRvvAvv
RvvAvRARAvRvRvRRRARvRRRB
AARBvRvRRRRRBvRRARvBRvvA
