vvvvvvBAAvvvRvRABBRvvRRv
RRvRLRRBvRBvvBRvvRvvRRRR
vvRvRvvRRBRARBRBRvvRRRRR
vvvBvRRvvRvvBvRARvBRRvRv
vvvvAAARRAvRvRvBRAvRRBRR
vRRRRLBRvLvAvBRvvRRRBRRR
RRvRRAAvRRRRvvBRvBvBRvvB
vRRRvvRAALLvvLRAvLvvRRvA
vRvvABARvvRvvARvvRRvvAvv
RvvAvRARAvRvRvRRRARvRRRA
