iiiiiiFAAiiiRiRAFFRiiRRi
RRiRLRRFiRFiiFRiiRiiRRRR
iiRiRiiRRFRARFRFRiiRRRRR
iiiFiRRiiRiiFiRARiFRRiRi
iiiiAAARRAiRiRiFRAiRRFRR
iRRRRLFRiLiAiFRiiRRRFRRR
RRiRRAAiRRRRiiFRiFiFRiiF
iRRRiiRAALLiiLRAiLiiRRiA
iRiiAFARiiRiiARiiRRiiAii
RiiAiRARAiRiRiRRRARiRRRA
AARFiRRRRRRRFiRRARiFRiiA
