IIIIIIBAAIIIRIRABBRIIRRI
RRIRLRRBIRBIIBRIIRIIRRRR
IIRIRIIRRBRARBRBRIIRRRRR
IIIBIRRIIRIIBIRARIBRRIRI
IIIIAAARRAIRIRIBRAIRRBRR
IRRRRLBRILIAIBRIIRRRBRRR
RRIRRAAIRRRRIIBRIBIBRIIB
IRRRIIRAALLIILRAILIIRRIA
IRIIABARIIRIIARIIRRIIAII
RIIAIRARAIRIRIRRRARIRRRA
AARBIRRRRRRRBIRRARIBRIIA
