vvvvvvBAAvvvRvRABBRvvRev
RRvRLRRBvRBvvBRvvRvvRRRR
vvRvRvvRRBRARBRBRvvRRRRR
vvIBvRRvvRvvBvRARvBRRvev
vvvvAAARRAvRvRvBRAvRRBRR
vRRRRLBRvLvAvBRvvRRRBRRR
RRvRRAAvRRRivvBvvBvBRvvL
vRRRvvRAALLvvLRAvLvvRRvA
vRvvABARvvRvvARvvARvvAvv
RvvAvRARAvRvRLRRRARvRRRA
AARBvRRRRRRRBvRIARvBRvvA
