E000NeEI0NeOeeNeii0EEeAEE
NANe0eeEAiE0reeNeeReR0eNe
ONA0ARA0e0ANE0EeNe0ieAeee
eA0ENOR0ROA00NE0r00E0rN0N
0IRN00rrER00eAee0eOEr000A
e0e0E0000R0R0AAe00OrNeeO0
ee0Ae00Oe0e0OeOeEre0eeEEe
Oe0Ee0NONe0000AeOe0eN00A0
0ANAONNAO0A0e0reErA0OA00A
AeNeE00r0RN00EArREOrAe0EA
ieAeOeNeeO0Ee00NeOENE0NeO
