U66UR66RUAR66RRAAU66RRRRU6U66R
R6666RR6R6666A6A666RR6ARURR66U
R6A66AU666666R6A66U6UURRRRR66U
6URR66UU66RRU666R6RU6RU666AAA6
U6R6RR666666A666UR66AR666R6666
6U6A6666666666RAR66U66R6UU6R6R
UU66A6RR66666AR6RR666AAA6U6U6U
6666RU66UR666RAU66R666R66RRRU6
RA66666U6A666A666666R6A6A6666A
6AAARU6UR666A66ARRUU6R6RUR666R
6R6R6A666RRRRU66RU66U6R6RR666R
6666R6URU6U6ARRURA6666UAU6A6UU
