IUUguuIgUu
uuucUggUcg
UcAcIIIUic
AAUIgAccUI
uigUiUuiAc
UicAUAiugA
iguAAUccIU
iAcIAIIUUi
UigiUIUgUA
uccuIgAIgu
