tA7777t7t7777I777777t77777I777
777ttt777t77777A77777A7777tt77
I777tA77777A77777A77t7I777I7tI
t77777A77777777777tII7I7A77777
77777t7tAt777t7t7777t7777AA777
AA7777A777A7t77777I7t777AI77At
777tt7777A77t777tII777tt777AA7
77777777I777tA7I7tI777At777I77
77I7777777A77777It7AAt7A77777t
7t777At777AI7A7t7777A7t77777A7
I7tII7777IAA77AI77t7A7A77I7777
7A777t777777777777777AI7777A7I
