7A44447474444I444444744444I444
444777444744444A44444A44447744
I4447A44444A44444A4474I444I47I
744444A444444444447II4I4A44444
44444747A7444747444474444AA444
AA4444A444A4744444I47444AI44A7
444774444A4474447II44477444AA4
44444444I4447A4I47I444A7444I44
44I4444444A44444I74AA74A444447
47444A7444AI4A474444A4744444A4
I47II4444IAA44AI4474A4A44I4444
4A4447444444444444444AI4444A4I
