qA2222q2q2222I222222q22222I222
222qqq222q22222A22222A2222qq22
I222qA22222A22222A22q2I222I2qI
q22222A22222222222qII2I2A22222
22222q2qAq222q2q2222q2222AA222
AA2222A222A2q22222I2q222AI22Aq
222qq2222A22q222qII222qq222AA2
22222222I222qA2I2qI222Aq222I22
22I2222222A22222Iq2AAq2A22222q
2q222Aq222AI2A2q2222A2q22222A2
I2qII2222IAA22AI22q2A2A22I2222
2A222q222222222222222AI2222A2I
