..........
..........
....0.....
..........
.....A.1..
AA........
A.........
.........0
...0.....A
..........
