6*d**Am8)6
m;886*?ddd
6u)dA*uu;8
*86?8A6?u)
;*?868;AA)
d;m;d;u*))
??m6*d)d8u
A?6;*m*?*m
88?86m?;)u
?)duA;6)m)
