A222..A212
2..212A2A.
0A.0A.2210
A0AA..2012
011111A200
2012A012..
11.A..0.A0
202.0A0202
1A21A.00.1
202.1220.2
