3u)u^)v^u8
3dd)3u^3v3
38d3v^iv8)
3d8)^)^8^A
^u^8u3^8d8
v8^ddAv^)v
8v3))i3)ii
vvuA))i3)^
))A3^8u)))
d)^u)duA^i
