UPRPUPRNPRArRrrRPRNRURPrRUPRRP
PNAPrPRrRiRPPPUUNRRPAPiPRPPPNP
iPPPURPAURRrPPPUPPPUPrRiRNPNrN
PARRPPPRRUPiPURrAAPPPPPPUrPRPN
RRPPrRPrrPPAPiAPPrPPARRRNRPrAP
iPAUAPPRNNPIIIRRRARPAPPrUPAIPA
PRRRAPURNRIPPNANRPPrNUNrNANrPN
PPNRrrrPUIPIPPPPPURiriNNPrPANN
RiPRRiPUAPrPRPPPPRPrRRAUPRPrNN
rUrUPIrUUAIIPNRPiRrriPPPPNPNNP
PirPrAPPPPPPUUPNPNPPUUANRPRPUA
iArAPPPURNRPRANPPPRNPUNPRPPNNR
