U7R7U7RN7RArRrrR7RNRUR7rRU7RR7
7NA7r7RrRiR777UUNRR7A7i7R777N7
i777UR7AURRr777U777U7rRiRN7NrN
7ARR777RRU7i7URrAA777777Ur7R7N
RR77rR7rr77A7iA77r77ARRRNR7rA7
i7AUA77RNN7IIIRRRAR7A77rU7AI7A
7RRRA7URNRI77NANR77rNUNrNANr7N
77NRrrr7UI7I77777URiriNN7r7ANN
Ri7RRi7UA7r7R7777R7rRRAU7R7rNN
rUrU7IrUUAII7NR7iRrri7777N7NN7
7ir7rA777777UU7N7N77UUANR7R7UA
iArA777URNR7RAN777RN7UN7R77NNR
