U6R6U6RN6RArRrrR6RNRUR6rRU6RR6
6NA6r6RrRiR666UUNRR6A6i6R666N6
i666UR6AURRr666U666U6rRiRN6NrN
6ARR666RRU6i6URrAA666666Ur6R6N
RR66rR6rr66A6iA66r66ARRRNR6rA6
i6AUA66RNN6IIIRRRAR6A66rU6AI6A
6RRRA6URNRI66NANR66rNUNrNANr6N
66NRrrr6UI6I66666URiriNN6r6ANN
Ri6RRi6UA6r6R6666R6rRRAU6R6rNN
rUrU6IrUUAII6NR6iRrri6666N6NN6
6ir6rA666666UU6N6N66UUANR6R6UA
iArA666URNR6RAN666RN6UN6R66NNR
