f1f11fff11ffAf11ff111fR1fFI
RF1fAffffAff1F1Ff11A1fff11R
I11R11R111111RIF1fRIff111RB
1ff1fIffF11fAAffAfAffR1FFfb
1R11f11RAAf111Ff1RRffR1RFF1
1111ff1AI1A1ffFfA1111111fIf
A1AA1111RAFf11AffR1f1ffFf1A
1ff11fR11f111f1A1fA11fAAfAf
1A1F1RR1AR11f111Af111f11f1f
1R11Rf1fFfff11F1FfA1Fff1ARb
fFRRAfAR1f11AfAI11FfFfR1f1f
