iEEA2EIRiI2E2ii22AIE22i22I
AA2IIA2E2i22i2IIAAE22222EE
AIii2iAAI2222i22IAA2Ai22I2
E222EIA2IA2A22IA2EEEI2I22E
2RiI2AIIi2iEI22IIi2Ii2AEAI
A2i2i2IE2AEEAA2AIIiEAiiAAI
IiIA222Ai22i22E2i2Ai2i2222
E2EA2E2IIIAREi22i2Ai222AI2
AAE22III22ARAIA22Ai22rEI2i
EiiA2EA222E2I2iE2IAE2rA22R
I2E2IiiiIE2E22A222iiAEi22I
