RARAAoRoooRARoRRoooARRRoRUAAAR
URoRRoooUooUooRURoRRUAoRoUAARR
ooRRoRoAoRRUoRUoUAoRURoAooURoU
ooUoRAoRRUARURRoRRRoooAoRRooAR
RAURRUoRoRRRRoARRRRURARAAooURA
RAURoooRoAooARRoURRRoooooRUoRA
RAAUURooARoooooooooRURoRooooRU
RRoAURRARoARoooRoooARoRRoRooRo
RRARRooRoooARoAAoooRooooUoRoRo
RoRRoRRRRRoURoRURRRUUUUoRRRRUo
oURooRoARoAoRUUURoRRAAURooUoRU
UoRoRoooRAoRoAooRRRRURRooUoRoR
