RAARiURiRiuRiRRiuiAuiRRRURAiAi
RRuuRiURiiURRRuuRRRuRiuUARiARA
RRRuuAuRuRRRUuRRUAURRAiRRRuURu
iRURURRRUuRARRiRiUiiRUUARRiRUi
RRRiuiiUURiiARURRiARAiRRRuRAuR
uuAuAARiUUiRuRiiuRARiRuuRiRuii
UiiRRRiRiUAiiAuiRARRiUiiiRuuiR
RARiiUiUiRAuRiRuiRiAAARiUiRiRA
RiARiiuUURiuAUiRRRuAiUiRiRiuRi
uAiuiiRiuRiRRUiRiARiiARRuAAUAR
uiRRiuiRRRRuiuRiRiiARRRRRRRRiU
iUiiiUiRARuiRuiAuuiiuRiiuiAuRR
