RAARiURiRi9RiRRi9iA9iRRRURAiAi
RR99RiURiiURRR99RRR9Ri9UARiARA
RRR99A9R9RRRU9RRUAURRAiRRR9UR9
iRURURRRU9RARRiRiUiiRUUARRiRUi
RRRi9iiUURiiARURRiARAiRRR9RA9R
99A9AARiUUiR9Rii9RARiR99RiR9ii
UiiRRRiRiUAiiA9iRARRiUiiiR99iR
RARiiUiUiRA9RiR9iRiAAARiUiRiRA
RiARii9UURi9AUiRRR9AiUiRiRi9Ri
9Ai9iiRi9RiRRUiRiARiiARR9AAUAR
9iRRi9iRRRR9i9RiRiiARRRRRRRRiU
iUiiiUiRAR9iR9iA99ii9Rii9iA9RR
