FAAFiUFiFiuFiFFiuiAuiFFFUFAiAi
FFuuFiUFiiUFFFuuFFFuFiuUAFiAFA
FFFuuAuFuFFFUuFFUAUFFAiFFFuUFu
iFUFUFFFUuFAFFiFiUiiFUUAFFiFUi
FFFiuiiUUFiiAFUFFiAFAiFFFuFAuF
uuAuAAFiUUiFuFiiuFAFiFuuFiFuii
UiiFFFiFiUAiiAuiFAFFiUiiiFuuiF
FAFiiUiUiFAuFiFuiFiAAAFiUiFiFA
FiAFiiuUUFiuAUiFFFuAiUiFiFiuFi
uAiuiiFiuFiFFUiFiAFiiAFFuAAUAF
uiFFiuiFFFFuiuFiFiiAFFFFFFFFiU
iUiiiUiFAFuiFuiAuuiiuFiiuiAuFF
