SERILE5555IL55E55AS55r5lR
55lL5SLI5555l5I55SIALIrrS
555AE555555S55jIrjr5AIIS5
AA55AEIESR5IlL5SSAIEr55AS
RL55lI5A5AArIL555r5I5r5A5
rlLSLlI5r5jrSrL555lLIA555
IE5LLISLEELr55RARrSLlAI55
LLrArSrALLAlRSrS5r555ISEI
ERSISISA5LI5A5A5Ill5rLSLr
ISj555LAA5A5EL55L55ESrEII
5lEA5SA5I55EIr5R55A5AI55I
