AAsRRRsAAAssAssREERsRAEsss
RsRAsRsAssAssEssssAAERRsss
EsssssREsRsRRsEssssREsAsRs
ssAEAsEsEsREEssREARRRsRAsE
sssARAEsAsAAEsRAsRAsssEsRs
REsssEsAEEAAEAAEsARssRARsE
sAERsARsAEsssREARsRsAsRRsR
RsssREsssEEssEAsARAsssEsEs
sEsssEAsAEssARRAsRREssRRss
sAssAssEEERsssAsssRsssssAs
sEssRsRAAAsssAEsERRsEssRss
