6r8r6r65rArA558AAr55A58err
5E855e8e5r55rrE55r85A55eEe
Ar55Er55rr58E55EA58rRe55A6
ee865rAAEAeE5e565rr68858r5
rEr85rIE5AEERA55er558EEEA6
rre6ErA5655e8rr56r55rr6868
A556re5585A8ARe5ee55Ere858
6rrA6AE5r585EA5rEEAr58E5A8
rrA6586rr58A6rr5Er5Eerr5Er
68r55ErEee8A8A5585rE66Ar55
585r5655555Aer65A555r8EEE6
