EjjRrjE0jRjBjjjBRAL0EBEA0R
BL0jBBjBjjAAjj0RRjj0L0BRjA
jjjjERAAjrRBAjjRAAjABALB0B
jjjBjREBB0jAAjEBjj00RjRjA0
ER0AAAARRREjLAjjEBEBjRjBj0
0EBABEj0jR0A0jLrj0ABjjjLjj
jjjjjE0EjjREEABj00jB00j0Ej
j0jjj0000R0RRBEjBBjjA00Rj0
A000jREjjj0jARjRjAjRjjEj0j
AAEjjRBELBEEEjLRBEjREEjjj0
0jrAE0A0RRjBR0jRRL0AEREjRj
