RIllNlINIAIAlNAUIUIRUIlRRlRUAN
AlRRAlINlUlUIUllAlURlIllUAlIIl
lIRIlIAllRNUlNlRllNUIURRlRURll
lAlllIANlllNRIlIRRRAlUlRIINURI
UlRNlIIIllIUUlRUUlRNlRARNAllUl
llRlRNNlNRIRIllRRIURlIRRIRRlIR
IIlRIIUAIRURlAlAlRlIlIUURIIRNI
IlIRllIAlUlllIIlIRRIRANlllAARU
AllRIURlRUIUARllRlUlRRlUllllRR
lAIANRlRAllNlIIIRIURUIRAARlNRR
NUIRRIRlRUUARUlIRUIllRRllNRUlU
RlRNlAINlIlIllIAllIRIURIAllUNR
