RIrrNrINIAIArNAUIUIRUIrRRrRUAN
ArRRArINrUrUIUrrArURrIrrUArIIr
rIRIrIArrRNUrNrRrrNUIURRrRURrr
rArrrIANrrrNRIrIRRRArUrRIINURI
UrRNrIIIrrIUUrRUUrRNrRARNArrUr
rrRrRNNrNRIRIrrRRIURrIRRIRRrIR
IIrRIIUAIRURrArArRrIrIUURIIRNI
IrIRrrIArUrrrIIrIRRIRANrrrAARU
ArrRIURrRUIUARrrRrUrRRrUrrrrRR
rAIANRrRArrNrIIIRIURUIRAARrNRR
NUIRRIRrRUUARUrIRUIrrRRrrNRUrU
RrRNrAINrIrIrrIArrIRIURIArrUNR
